設置於=配置於
（=(
）=)
開源=開放原始碼
頁面佈局=頁面排版
佈局調整=排版調整
從而減少=進而減少
以實現=以達到
一風吹=一筆勾銷
丁克夫妻=頂克族
二流子=流氓
八旗子弟=紈褲子弟
三文魚=鮭魚
上座率=票房紀錄
下崗=失業
下劃線=底線
也門=葉門
土豆條=薯條
大氣污染=空氣污染
大腕=重量級人物
大鍋=小耳朵
小太陽=獨生子
小金庫=私房錢
小型單放機=隨身聽
小皇帝=獨生女
小帳=小費
小學=國小
工齡=年資
不客氣=不會
不限量=吃到飽
中標=得標
內存=記憶體
內貿=內銷
公交車=公車
公交站=公車站
公房=公家宿舍
分成=抽成
分數線=最低錄取標準
升級=更新
厄瓜多=厄瓜多爾
巴羅克藝術=巴洛克藝術
幻燈片=投影片
引廠進店=專櫃
手柄=搖桿
扎啤=生啤酒
文件夾=資料夾
文娛活動=康樂活動
方便麵=速食麵
毛腳女婿=準女婿
毛腳媳婦=準媳婦
水門汀=水泥
牛鼻子=要害
主人公=主角
主存=主記憶體
主板=主機板
代用鹽=低鈉鹽
兄弟院校=姊妹校
出版物=出版品
出租車=計程車
出糧=領薪水
北京時間=中原標準時間
半包價式旅遊=半自助式旅遊
半截美=發財車
半邊家庭=單親家庭
卡塔爾=卡達
句號=句點
只讀存儲器=唯讀記憶體
史瓦濟蘭=斯威士蘭
外圍設備=周邊設備
幼兒園=幼稚園
打印=列印
打印機=印表機
打橫泡=攪局
本科生=大學生
民樂=國樂
甘比亞=岡比亞
生物食品=天然食品
甩賣=拋售
白班=日班
白酒=高粱酒
白葡萄酒=白酒
立交橋=交流道
交互=互動
任務欄=工作列
份兒飯=套餐
光榮榜=榮譽榜
光標=游標
全線飄紅=長紅
冰毒=安非他命
冰棍=冰棒
列車員=車掌
危地馬拉=瓜地馬拉
吊空=暴漲
吐瓦魯=圖瓦盧
向後兼容=向下兼容
回頭客=常客
地鐵=捷運
多國家公司=跨國公司
字段=資料欄
字符=字元
尖子=傑出人士
忙音信號=忙線訊號
成服=成衣
托幼=托嬰
收轉臺=轉播站
死機=當機
灰色影片=大爛片
老視眼=老花眼
老摳=吝嗇鬼
肉食鴿=食用鴿
肉雞=飼料雞
自行車=腳踏車
自定義=客製化
自選市場=超級市場
色粉=碳粉
行業病=職業病
低谷=谷底
低常兒童=智障兒
冷背=冷門
冷麵=涼麵
初中=國中
利比裡亞=賴比瑞亞
利稅=營業稅
吹喇叭=拍馬屁
尾氣測量=排氣測量
希拉里=希拉蕊
床上戲=床戲
快班=資優班
批文=許可證
技校=職業學校
抓空字=抽空
攻關=突破瓶頸
步行街=行人徒步區
步談機=對講機
沙特阿拉伯=沙烏地阿拉伯
系列企業=關係企業
走讀生=通學生
車費=車資
車照=駕駛執照
巡診=巡迴醫療
兒童文化宮=兒童活動中心
刷屏=洗版
協議=協定
卸載=解除安裝
受眾=閱聽人
受獎產品=得獎產品
坦克=戰車
坦尚尼亞=坦桑尼亞
垃圾=樂色
夜餐=宵夜
尚比亞=贊比亞
居民身分證=國民身分證
底板價=基價，底價
房齡=屋齡
旺銷，快銷=暢銷
易拉罐=易開罐
朋客=龐克族
服務器=伺服器
東加=湯加
武術=國術
沸點新聞=焦點新聞
炊事員=廚師
的士頭=發財車
盲人學校=啟明學校
盲區=盲點
知識密集=技術密集
知識產權=智慧財產權
空中客車=空中巴士
空哥=空中少爺
空調鞋=氣墊鞋
肯亞=肯尼亞
芝士=起司
花生=土豆
花帶子，黃帶=A片
金槍魚=鮪魚
阿拉伯聯合大公國=阿位伯聯合酋長國
青年宮=青年活動中心
亭式車站=候車亭
保育院=育幼院
保暖杯=保溫杯
保職停薪=留職停薪
信號=訊號
剃鬚刀=刮鬚刀
屏幕=螢幕
屏幕文字=字幕
後備=備份
政治避難=政治庇護
故事片=劇情片
查德=乍得
流水線=生產線
突尼西亞=突尼斯
美女=正妹
面市=上市
風景微縮區=小人國
飛機乘務員=空服員
個人計算機=個人電腦
倒休=調班
倒讀秒=倒數計時
原音帶=原聲帶
原珠筆=原子筆
哥特式藝術=哥德式藝術
套服=套裝
展賣=展售
旅遊局=觀光局
旅遊車=遊覽車
旅遊農業=觀光農業
桑拿浴=三溫暖
浪頭=潮流
消息=訊息
烏賊、墨魚=花枝
病休=請病假
破碼器=解碼器
笑星=諧星
粉絲=冬粉
索馬利亞=索馬里
航班=班機
茶點=點心
退出登錄=登出
逃生=逃學生
配演=配角
除塵器=吸塵器
馬拉威=馬拉維
馬爾代夫=馬爾蒂夫
高考=聯考
高等院校=大專院校
高標準內銷房=高級住宅
高壓鍋=壓力鍋
高檔=高級
假牌=仿冒品
做底=打底
健美褲=韻律褲
動畫片=卡通片
唯書=死讀書
商標菜=招牌菜
域=網域
堂食=內用
堵車=塞車
婚外戀=婚外情
專列=加班車
崗位培訓=在職訓練
彩電=彩色電視機
彩電牆=電視牆
掃描儀=掃描器
掛機=連線
探親假=省親假
救生盒=急救箱
救命電話=生命線
教齡=教學年資
條形碼=條碼
梵高=梵穀
混血車=拼裝車
現房=成屋
畢加索=畢卡索
盒飯=便當
硅谷=矽谷
票販子=黃牛
視頻=影片
第二課堂=課外活動
第二職業=副業
第三次浪潮=第三波
第三產業=服務業
脫產=離職
莫三鼻克=莫桑比克
莫奈=莫內
莫差特=莫札特
袖標=臂章
被動吸菸=抽二手菸
設置=設定
軟包裝=鋁箔包
軟件=軟體
軟件包=套裝軟體
通宵電影=午夜場
通過=透過
速遞=快遞
頂班=代班
頂價=天價
勞動保險=勞工保險
博客=部落格
喇叭筒=擴音器
喜力=海尼根
喬布斯=賈伯斯
單反相機=單眼相機
單本劇=單元劇
單位=組織
尋呼=呼叫
復映片=二輪片
揭彩=剪綵
散件=零件
斯大林=史達林
普利策獎=普利茲獎
普京=普丁
智力玩具=益智玩具
智能手機=智慧型手機
智殘人=智障人士
朝鮮=北韓
期房=預售屋
殘次品=瑕疵品
港客=香港觀光客
無用信息=雜訊
無塵粉筆=無灰粉筆
無繩電話=無線電話
登錄=登入
發短信=傳簡訊
發郵件=寄信
硬件=硬體
硬盤=硬碟
程序=程式
窗口=視窗
筆記本=筆電
筆記本電腦=筆記型電腦
統一意見=共識
統考=聯考
註冊表=系統資料庫
超常兒童=天才兒童
超編=超額
進分=進帳
郵遞員=郵差
開門紅=好采頭
集裝箱=貨櫃
項目=專案
傳統風味=古早味
奧巴馬=歐巴馬
愛侶動物=寵物
新西蘭=紐西蘭
新西蘭=紐西蘭
業餘活動=休閒活動
歇班=休假
滑坡=下滑
瑙魯=諾魯
聖誕=耶誕
腦流失=人才外流
腦庫=智囊團
裝系統=灌係統
資源管理器=資料總管
跟蹤服務=售後服務
路條=通行證
過街橋=天橋
道․瓊斯指數=道瓊指數
達芬奇=達文西
電子信函=電子郵件
電子屏幕=電子看板
電視大學=空中大學
電視系列片=電視影集
電腦紅娘=電腦擇友
電腦磁盤=磁碟
電熱毯=電毯
鼠標=滑鼠
圖像=影像
圖標=圖示
嫩膚=護膚
實現=實作
對象=物件
慈悲殺人=安樂死
慢班=後段班
慢運動=慢動作
慣偷=慣竊
漢姆雷特=哈姆雷特
熊貓=貓熊
熒光屏=螢光幕
監督電話=投訴電話
綠色食品=健康食品
網絡=網路
臺式計算機=桌上型電腦
輕騎=輕型機車
酸牛奶=優酪乳
酸奶=優格
寬心丸=定心丸
寮國=老撾
導火索=導火線
導彈=飛彈
廠校掛鉤=建教合作
廣告電影=廣告片
摩托車=機車
撥號工具=撥號器
數字唱片=數位唱片
數碼相機=數位相機
數據=資料
數據庫=資料庫
暴雨=豪雨
樣片=試映片
樣板=模範
潑髒水=造謠
熱貨=搶手貨
熱銷=熱賣
緩存=快取
衛生筷=免洗筷
複印=影印
課時工資=鐘點費
調用=呼叫
賣大戶=量販
賣大號=量販
質量管理=品質管制
銷價=售價
駕校=駕訓班
壁紙=桌面
操作系統=作業系統
激光=鐳射
激光打印機=雷射印表機
激光唱機=雷射唱盤
激光視盤=影碟
盧安達=盧旺達
薌劇=歌仔戲
螢幕廣告=電視廣告
輸液=點滴
檔次=等級
獲得者=得主
臨時戶口=流動戶口
薯片=洋芋片
避孕套=保險套
擴銷=促銷
斷檔、缺售=缺貨
簡裝=平裝
轉折點=轉捩點
雙擊=輕按兩下
爆冷=爆冷門
識別=辨識
鏈路=連結
獻血=捐血
蘇裡南=蘇利南
攝像機=攝影機
鐵哥們=哥兒們
魔方=魔術方塊
攤床，攤檔=攤位
變量=變數
顯示器=螢幕
